........................
.##########..##########.
.#........#..#........#.
.#.@@@@@@.#..#.@@@@@@.#.
.#.@....@.#..#.@....@.#.
.#.@.@@.@.#..#.@.@@.@.#.
.#.@.@@.@.#..#.@.@@.@.#.
.#.@....@.#..#.@....@.#.
.#.@@@@@@.#..#.@@@@@@.#.
.#........#..#........#.
.##########..##########.
........................